000000000000000000000000000000000000000000000000000000000000000000000000000000000000000000000000000000000000000
000000000000000000000000000000000000000000000111111111111100000000000000001111111111000000000000000000000000000
000000000000000000000000000000000000000001111222222222222211111100000000000000002222111111111111100000000000000
111111111000000000000000000000000000000002222222222222222222222200000000000000000000222222222222211111110000000
222222221111111111111100000000000000011122222222222000000000000000000000000000000000000000000000000000000000000
000000000000000000000000000000000000000000000000000000000000000000000000000000000000000000000000000000000000000
000000000000000000000000000000000000000000000000000000000000000000000000000000000000000000000000000000000000000
000000011111111000000000000000000000000000000000000000000000000000011111000000000000000000000000011100000000000
000002222222222220000000000000000000000000000000000000000000000001122222110000000000000000000111122211110000000
000012222222222221110000000000000000000000000000000000000000000002222222221111111100000000001222222222221100000
000000000000000000000000000000000000000000000000000000000000000000000000000000000000000000000000000000000000000
111111111111111111111111111111111111111111111111111111111111111111111111111111111111111111111111111111111111111